Level 00 - Testing
lockout 
@@@@@@@@@@@@@@@@@@@@@@@@@@@@@@@@@@##
@@@@@@@@@@@@@@@@@@@@@@@@@@@@@@@@@@##
@@@@@@@@@@@@@@@@@@@@@@@@@@@@@@@@@@##
| | | | | | @@| | | | | | | | | | ##
| 11| | | | %%| | | | | 33| | | | ##
| | | | | | @@| | | | | | | | | | ##
| | | | | | @@| | | | | | | | | | ##
| | | | | | %%%%| 22| | | | |44 | ##
| | AABBCCDD@@FF                  ##
| | | | | | | | | | | | | | | | | ##
######################################################