Level 00 - Testing
lockout lockexec
@@@@@@@@@@@@@@@@@@@@@@@@@@@@@@@@@@##
@@@@@@@@@@@@@@@@@@@@@@@@@@@@@@@@@@##
@@@@@@@@@@@@@@@@@@@@@@@@@@@@@@@@@@##
| | | | | | @@| | | | | | | | | | ##
| 11| | | | %%| | | | | 33| | | | ##
| | | | | | @@| | | | | | | | | | &&
| $ | | | | @@| | | | | | | | | | ##
| | | | | | %%%%| 22| | | | |44 | ##
| | AABBCCDD@@FF                  ##
cAcBc1c`c~c1c0c_c-c;c"ccc c c c 
######################################################