Level 01 - Escape to the grass
le lo
@@@@@@@@@@@@@@@@@@%%@@@@@@@@@@
@@| | | @@| | | |A|B|C| | | @@
@@| $s| @@| | | | | | | | | @@
@@| | | @@| | | | |*| | | | @@
@@| | | @@| | | | | | | | | @@
@@| | | %%| | | !A!B!C| | | @@
@@@@@@@@@@@@@@@@@@%%@@@@@@@@@@