Level 02 - Learning to pull
Hold space while facing a block to pull it
le lo
##########&&##########
##| | | | c | | | | ##
##| | | | | | | | | ##
&&c | | | | | | | c &&
##| | | | $s| | | | ##
##| | | | | | | | | ##
@@@@@@@@@@%%@@@@@@@@@@
@@| | | | | | | | | @@
@@| | | | | | | | | @@
@@| | | | | | |P| | @@
@@@@@@@@@@@@@@|U@@@@@@
@@@@@@@@@@@@@@|L@@@@@@
@@@@@@@@@@@@@@|L@@@@@@