Level 02 - Hold space to pull - Escape is always the goal
le lo
######################
##| | | | | | | | | ##
##| | | | | | | | | ##
&&c | | | | | | | c &&
##| | | | $s| | | | ##
##| | | | | | | | | ##
@@@@@@@@@@%%@@@@@@@@@@
@@| | | | | | | | | @@
@@| | | | | | | | | @@
@@| | | | |1| | | | @@
@@@@@@@@@@|2@@@@@@@@@@
@@@@@@@@@@|3@@@@@@@@@@
@@@@@@@@@@|4@@@@@@@@@@