Level 05 - Writing Your Own Code
Use 1 to set the top left and 2 to set the bottom right of the execution region
lo
#################################
##| | | | | | | | | | | | c1| | ##
##| $e| | | | | | | | | | ##| | ##
##| | !p!=!p!r!i!n!t| | | ##| | ######
##| | | | | | | | | | | | ##| | c6  c9
##| | |p|(|1| | | |)| | | ############
##| | | | | | | | | | | | | | | ##
##| | |2|3|8| |+|*| | | | 3344| ##
##| | | | | | | | | | | | | | | ##
#################################