Level 05 - Learning to write code
Use 1 to set the top left and 2 to set the bottom right of the blue region
lo
#################################
##| | | | | | | | | | | | c1| | ##
##| | | | | | | | | | | | ##| | ##
##| | !p!=!p!r!i!n!t| | | ##| | ######
##| | | | | | | | | | | | ##| | c6  c9
##| | !p!(|1| $w| !)| | | ############
##| | | | | | | | | | | | | | | ##
##| | |2|3|8| |+|*| | | | 3344| ##
##| | | | | | | | | | | | | | | ##
#################################