Level 07 - Clear The Mess
When execution succeeds the output region is overwritten
le
@@@@@@@@@@@@@@@@@@@@@@@@@@@@@@@@@@@@@@@@@@@@@@@@@@@@@@@@@@@@@@@@@@@@@@@@@@@@@@@@@@@@
c@$e| |@| | c#| | | | | | | | | | | | | | | | | | | | | | | | | | | | | | | | | | cM
@@@@@@@@@@%%@@@@@@@@@@@@@@@@@@@@@@@@@@@@@@@@@@@@@@@@@@@@@@@@@@@@@@@@@@@@@@@@@@| | cE
@@11| | | |#| | | @@!v|m|e|scs|m|e|s|s|mce|s|s!m|e|s|s|m|e!s|s|m|e|s|s|m|e|s|s    cS
@@| |p|(|'| |'|)| @@|@|m|e|scs|m|e|s|s|mce|s|s|m|e|s!s|m|e|s|s|m|e|s|s|m|e|s|s    cS
@@| | | | | | | 22@@!^|m|e|scs|m|e|s|s|mce|s|s!m|e|s|s|m|e!s|s|m|e|s|s|m|e|s|s    cY
@@@@@@@@@@@@@@@@@@@@@@@@@@@@@@@@@@@@@@@@@@@@@@@@@@@@@@@@@@@@@@@@@@@@@@@@@@@@@@@@@@@@