Misc

| | | | | | | | | PP| | |
| | |A| | | | | | |XXXXX|
| | | |B|B| |S  | | | | |
| | | | | |C|6|C| | | | |
| | | | | | | | | | | | |
| | | | | | | | | | | | |
| | | | | | | | | | | | |