Congrats, you made it to the sandbox!

| | | | | | | | | | | | | | | | | | | | | | | | | | | | | | | | | | | | | | | | | | | | | | | | | | | | | | | | | | | | | | | | | | | | | | | | | | | | | | | | | | | | | | | | | | | | | | | | | | | | | | | | | |
| | |p|(|"|0|1|2|3|4|5|6|7|8|9|a|b|c|d|e|f|g|h|i|j|k|l|m|n|o|p|q|r|s|t|u|v|w|x|y|z|A|B|C|D|E|F|G|H|I|J|K|L|M|N|O|P|Q|R|S|T|U|V|W|X|Y|Z|!|\|"|#|$|%|&|'|(|)|*|+|,|-|.|/|:|;|<|=|>|?|@|[|\|]|^|_|`|{|||}|~|"|)| | | |
| | | | | | | | | | | | | | | | | | | | | | | | | | | | | | | | | | | | | | | | | | | | | | | | | | | | | | | | | | | | | | | | | | | | | | | | | | | | | | | | | | | | | | | | | | | | | | | | | | | | | | | | | |
| 33| | | | | | | | | | | | | | | | | | | | | | | | | | | | | | | | | | | | | | | | | | | | | | | | | | | | | | | | | | | | | | | | | | | | | | | | | | | | | | | | | | | | | | | | | | | | | | | | 44| | | | | | |
| | | | | | | | | | | | | | | | | | | | | | | | | | | | | | | | | | | | | | | | | | | | | | | | | | | | | | | | | | | | | | | | | | | | | | | | | | | | | | | | | | | | | | | | | | | | | | | | | | | | | | | | | |
| 11| | | | | | | | | | | | | | | | | | | | | | | | | | | | | | | | | | | | | | | | | | | | | | | | | | | | | | | | | | | | | | | | | | | | | | | | | | | | | | | | | | | | | | | | | | | | | | | | | | | | | | | |
| | |d|e|f| |f|i|b|(|n|)|:|
| | | |f|=|[|0|,|1|]
| | | |f|o|r| |i| |i|n| |r|(|2|,|n|+|1|)|:
| | | | |f|.|a|p|p|e|n|d|(|f|[|-|1|]|+|f|[|-|2|]|)
| | | |p|(|f|)| | 
| | | | | | | | |               $w
| | |f|i|b|(|2|2|)
| | | | | | | | | | | | | | | | | | | | | | | | | 22| | | | | | | | | | | | | |
| 
|
|
|
|
|
|
|
|
|
|
|
|
|
|
|
|
|
|
|
|
|
|
|
|
|
|
|
|
|
|
|
|
|
|
|