Test Level
lockE lockQ
|#|#|#|#|#|#|#|#|#|#|#|#|#|#|#|#|#|#|#|#|#
|#| | PE| | | | | | | | | | | | | | | | |#
|#\#|x|=|i|n|p|u|t|(|)| | | | | | | | | |#
|#\#|f|o|r| |i| |i|n| |r|a|n|g|e|(|9|)|:|#
|#\#| |p|r|i|n|t|(|i|)| | | | | | | | | |#
|#| |x|=|0| | | | | | | | | | | | | | | |#
|#| |w|h|i|l|e| |x|:| | | | | | | | | | |#
|#| | |x|x|=|2| | | | | | | | | | | | | |#
|#| |p|(|9|)| | | | | | | | | | | | | | |#
|#| | | | | | | | | | | | | | | | | | | |#