Test Level
lockE lockQ
##########################################
##| | | | | | | | | | | | | | | | | | | ##
##| | | |x|=|8| | | | | | | | | | | | | ##
##| | | |p|(|9|*|x|)| | | | | | | | | | ##
##| | | | | | | | | | | | | | | | | | | ##
##| | | | | | | | | | | | | | | | | | | ##
##| | | | | | | | | | | | | | | | | | | ##
##| | | | | | | | | | | | | | | | | | | ##
##| | | | | | | | | | | | | | | | | | | ##
##| | | | | | | | | | | | | | | | | | | ##
##$ | | | | | | | | | | | | | | | | | | ##