Test Level
lockE lockQ
##########################################
##11| PE| | | | | | | | | | | | | | | | ##
##|#|x|=|i|n|p|u|t|(|)| | | | | | | | | ##
##|#|f|o|r33|i| |i|n| |r|a|n|g|e|(|9|)|:##
##|#| |p|r|i|n|t|(|i|)22| | | | | | | | ##
##| |x|=|0| | | | | | | | | | | | | | | ##
##| |w|h|i|l|e| |x|:||| | | | | | | | | ##
##| | !x!x!=|2| | | | | | | $E| | | | | ##
##| |p|(|9|)| | | | | | | 44| | | | | | ##
##| | | | | | | | | | | | | | | | | | | ##