Test Level
lockE lockQ
|#|#|#|#|#|#|#|#|#|#|#|#|#|#|#|#|#|#|#|#|#
|#| | PE| | | | | | | | | | | | | | | | |#
|#\#| | | | | | | | | |e|l|l|o| | | | | |#
|#\#| !p!r!i!n!t!(|c|o|d|e| | | |)| | | |#
|#| | | | | | | | | | | | | | | | | | | |#
|#| | \#|1|2|3|4|+|-| | | | | | | | | | |#
|#| | | | | | | | | | | | | | | | | | | |#
|#| | | | | | | |w|h|i|l|e| |T|r|u|e|:| |#
|#| |#| | | | | | |p|r|i|n|t|(|7|)| | | |#
|#| |#|#|#|#|#|#|#|#|#|#|#|#|#|#|#|#|#| |#