Test Level
lockE lockQ
##########################################
##| | | | | | | | | | | | | | | | | | | ##
##| | 11|x|=|8| | | | | | | | | | | | | ##
##| | | |p|(|9|*|x|)| | | | | | | | | | ##
##| | | | | | | | | 22| | | | | | | | | ##
##| | | | | | | | | | | | | | | | | | | ##
##| | | | | | | | | | | | | | | | | | | ##
##| | | | | | | | | | 33| | | | | | | | ##
##| | | | | | | | | | | | | | | | | | | ##
##| | | | | | | | | | | | | | | 44| | | ##
##$ | | | | | | | | | | | | | | | | | | ##