Test Level
lockE lockQ
|#|#|#|#|#|#|#|#|#|#|#|#|#|#|#|#|#|#|#|#|#
|#| | PE| | | | | | | | | | | | | | | | |#
|#| |x|=|i|n|p|u|t|(|)| | | | | | | | | |#
|#| |f|o|r| |i| |i|n| |r|a|n|g|e|(|9|)|:|#
|#| | |p|r|i|n|t|(|i|)| | | | | | | | | |#
|#| | | | | | | | | | | | | | | | | | | |#
|#\#| | | | | | | | | | | | | | | | | | |#
|#| | | | | | | | | | | | | | | | | | | |#
|#| | | | | | | | | | | | | | | | | | | |#
|#| | | | | | | | | | | | | | | | | | | |#