Level 00 - Testing

11########################################
##|f|o|r| |x| |i|n| |r|(|9|)|:| | | | | ##
##| |p|(|x|*|*|3|)| | | | | | | | | | | ##
##| | | | | | | | | | 33| | | | 22| | | ##
##| | | | | | | | | | | | | | | | | | | ##
##| | | | | | | | | dddd| | |     | | | ##
##| | | | | | | | | | | | | | | | | | | %%
##| | | | | cccccc| | | | | | | 44| | | ##
##$ | | | | | | | | | | | | | | | | | | ##